Grapheme	IPA
^csekély$	t͡ʃ ɛ k eː j
^gyér$	ɟ eː r
^kevés$	k ɛ v eː ʃ
^kicsi$	k i t͡ʃ i
^kis$	k i ʃ
^kisded$	k i ʃ d ɛ d
^parányi$	p ɒ r aː ɲ i
^piciny$	p i t͡s i ɲ
^piszli$	p i s l i
^rövid$	r ø v i d
^sekély$	ʃ ɛ k eː j
^szimatol$	s i m ɒ t o l
^holmi$	h o l m i
^semmi$	ʃ ɛ mː i
^fáj$	f aː j
^biggyeszt$	b i ɟː ɛ s t
^deputál$	d ɛ p u t aː l
^fűz$	f yː z
^olt$	o l t
^pótol$	p oː t o l
^szerez$	s ɛ r ɛ z
^tesz$	t ɛ s
^akció$	ɒ k t͡s i oː
^baj$	b ɒ j
^dolog$	d o l o ɡ
^gond$	ɡ o n d
^história$	h i ʃ t oː r i ɒ
^ügy$	y ɟ
^rá$	r aː
^ismét$	i ʃ m eː t
^másutt$	m aː ʃ u tː
^meg$	m ɛ ɡ
^megint$	m ɛ ɡ i n t
^új$	uː j
^viszon$	v i s o n
^viszont$	v i s o n t
^vissza$	v i sː ɒ
^év$	eː v
^öreg$	ø r ɛ ɡ
^rend$	r ɛ n d
^tragacs$	t r ɒ ɡ ɒ t͡ʃ
^ájer$	aː j ɛ r
^ég$	eː ɡ
^lég$	l eː ɡ
^levegő$	l ɛ v ɛ ɡ øː
^luft$	l u f t
^szél$	s eː l
^mind$	m i n d
^monnó$	m o nː oː
^csupa$	t͡ʃ u p ɒ
^egyedül$	ɛ ɟ ɛ d y l
^heon$	h ɛ o n
^külön$	k y l ø n
^maga$	m ɒ ɡ ɒ
^magán$	m ɒ ɡ aː n
^tulajdon$	t u l ɒ j d o n
^már$	m aː r
^hébehóba$	h eː b ɛ h oː b ɒ
^mindig$	m i n d i ɡ
^csapat$	t͡ʃ ɒ p ɒ t
^csata$	t͡ʃ ɒ t ɒ
^csomó$	t͡ʃ o m oː
^csoport$	t͡ʃ o p o r t
^halom$	h ɒ l o m
^kazal$	k ɒ z ɒ l
^kalangya$	k ɒ l ɒ n ɟ ɒ
^légió$	l eː ɡ i oː
^nagy$	n ɒ ɟ
^nép$	n eː p
^regiment$	r ɛ ɡ i m ɛ n t
^sok$	ʃ o k
^sor$	ʃ o r
^summa$	ʃ u mː ɒ
^sűrű$	ʃ yː r yː
^szám$	s aː m
^szapora$	s ɒ p o r ɒ
^tömb$	t ø m b
^és$	eː ʃ
^kedig$	k ɛ d i ɡ
^pedig$	p ɛ d i ɡ
^állat$	aː lː ɒ t
^beste$	b ɛ ʃ t ɛ
^bestia$	b ɛ ʃ t i ɒ
^pár$	p aː r
^rokkan$	r o kː ɒ n
^tenyészik$	t ɛ ɲ eː s i k
^egyed$	ɛ ɟ ɛ d
^hangya$	h ɒ n ɟ ɒ
^alma$	ɒ l m ɒ
^április$	aː p r i l i ʃ
^fél$	f eː l
^környék$	k ø r ɲ eː k
^mellék$	m ɛ lː eː k
^szak$	s ɒ k
^táj$	t aː j
^vidék$	v i d eː k
^rész$	r eː s
^tartomány$	t ɒ r t o m aː ɲ
^ág$	aː ɡ
^kar$	k ɒ r
^ér$	eː r
^jön$	j ø n
^fér$	f eː r
^hoz$	h o z
^kap$	k ɒ p
^követ$	k ø v ɛ t
^vall$	v ɒ lː
^nyíl$	ɲ iː l
^hamu$	h ɒ m u
^kérd$	k eː r d
^kereskedik$	k ɛ r ɛ ʃ k ɛ d i k
^kér$	k eː r
^pitizik$	p i t i z i k
^remél$	r ɛ m eː l
^gyűlik$	ɟ yː l i k
^eleve$	ɛ l ɛ v ɛ
^ottogyol$	o tː o ɟ o l
^tott$	t o tː
^augusztus$	ɒ u ɡ u s t u ʃ
^néni$	n eː n i
^tanti$	t ɒ n t i
^ősz$	øː s
^derék$	d ɛ r eː k
^görbe$	ɡ ø r b ɛ
^indít$	i n d iː t
^száll$	s aː lː
^tol$	t o l
^curukk$	t͡s u r u kː
^retúr$	r ɛ t uː r
^cigány$	t͡s i ɡ aː ɲ
^hiba$	h i b ɒ
^hitvány$	h i t v aː ɲ
^ócska$	oː t͡ʃ k ɒ
^pokol$	p o k o l
^rossz$	r o sː
^selejt$	ʃ ɛ l ɛ j t
^szegény$	s ɛ ɡ eː ɲ
^vacak$	v ɒ t͡s ɒ k
^csap$	t͡ʃ ɒ p
^katasztrófa$	k ɒ t ɒ s t r oː f ɒ
^tragédia$	t r ɒ ɡ eː d i ɒ
^táska$	t aː ʃ k ɒ
^isbufa$	i ʃ b u f ɒ
^ránt$	r aː n t
^süt$	ʃ y t
^héj$	h eː j
^karaj$	k ɒ r ɒ j
^kopács$	k o p aː t͡ʃ
^ugat$	u ɡ ɒ t
^füröszt$	f y r ø s t
^kebel$	k ɛ b ɛ l
^öböl$	ø b ø l
^hat$	h ɒ t
^tud$	t u d
^él$	eː l
^eleven$	ɛ l ɛ v ɛ n
^évődik$	eː v øː d i k
^prüszköl$	p r y s k ø l
^vész$	v eː s
^zab$	z ɒ b
^lesz$	l ɛ s
^böjt$	b ø j t
^éh$	eː h
^kopár$	k o p aː r
^koplal$	k o p l ɒ l
^mackó$	m ɒ t͡s k oː
^medve$	m ɛ d v ɛ
^toportyánféreg$	t o p o r c aː n f eː r ɛ ɡ
^dér$	d eː r
^szakáll$	s ɒ k aː lː
^toll$	t o lː
^deli$	d ɛ l i
^drágalátos$	d r aː ɡ ɒ l aː t o ʃ
^ékes$	eː k ɛ ʃ
^képes$	k eː p ɛ ʃ
^ragyiva$	r ɒ ɟ i v ɒ
^szép$	s eː p
^tekint$	t ɛ k i n t
^belül$	b ɛ l y l
^enyett$	ɛ ɲ ɛ tː
^érte$	eː r t ɛ
^fejében$	f ɛ j eː b ɛ n
^felől$	f ɛ l øː l
^folytán$	f o j t aː n
^képest$	k eː p ɛ ʃ t
^miá$	m i aː
^ok$	o k
^tőle$	t øː l ɛ
^után$	u t aː n
^végett$	v eː ɡ ɛ tː
^jut$	j u t
^lább$	l aː bː
^lábbog$	l aː bː o ɡ
^tetik$	t ɛ t i k
^beteg$	b ɛ t ɛ ɡ
^lel$	l ɛ l
^romlik$	r o m l i k
^hervad$	h ɛ r v ɒ d
^kór$	k oː r
^ágy$	aː ɟ
^folyik$	f o j i k
^lóca$	l oː t͡s ɒ
^nyoszolya$	ɲ o s o j ɒ
^elöl$	ɛ l ø l
^korán$	k o r aː n
^nyit$	ɲ i t
^hisz$	h i s
^kajál$	k ɒ j aː l
^bendő$	b ɛ n d øː
^gömböc$	ɡ ø m b ø t͡s
^has$	h ɒ ʃ
^hatak$	h ɒ t ɒ k
^hézag$	h eː z ɒ ɡ
^horpasz$	h o r p ɒ s
^jonh$	j o n h
^gurtni$	ɡ u r t n i
^majc$	m ɒ j t͡s
^öv$	ø v
^retesz$	r ɛ t ɛ s
^surc$	ʃ u r t͡s
^hajt$	h ɒ j t
^horgaszt$	h o r ɡ ɒ s t
^horog$	h o r o ɡ
^szeg$	s ɛ ɡ
^jószág$	j oː s aː ɡ
^bakló$	b ɒ k l oː
^bimbó$	b i m b oː
^bodócs$	b o d oː t͡ʃ
^bogyó$	b o ɟ oː
^szem$	s ɛ m
^közepett$	k ø z ɛ p ɛ tː
^goromba$	ɡ o r o m b ɒ
^kövér$	k ø v eː r
^tetemes$	t ɛ t ɛ m ɛ ʃ
^tohonya$	t o h o ɲ ɒ
^trabális$	t r ɒ b aː l i ʃ
^nyír$	ɲ iː r
^madár$	m ɒ d aː r
^szárny$	s aː r ɲ
^eszik$	ɛ s i k
^fal$	f ɒ l
^harap$	h ɒ r ɒ p
^mar$	m ɒ r
^keserű$	k ɛ ʃ ɛ r yː
^keserves$	k ɛ ʃ ɛ r v ɛ ʃ
^mord$	m o r d
^fekete$	f ɛ k ɛ t ɛ
^korom$	k o r o m
^roh$	r o h
^abrosz$	ɒ b r o s
^berhe$	b ɛ r h ɛ
^cserge$	t͡ʃ ɛ r ɡ ɛ
^daróc$	d ɒ r oː t͡s
^fedél$	f ɛ d eː l
^lazsnak$	l ɒ ʒ n ɒ k
^lep$	l ɛ p
^lepedő$	l ɛ p ɛ d øː
^pokróc$	p o k r oː t͡s
^takar$	t ɒ k ɒ r
^terít$	t ɛ r iː t
^mennyezet$	m ɛ ɲː ɛ z ɛ t
^buta$	b u t ɒ
^vak$	v ɒ k
^világ$	v i l aː ɡ
^hurka$	h u r k ɒ
^kolbász$	k o l b aː s
^vér$	v eː r
^leng$	l ɛ n ɡ
^rebeg$	r ɛ b ɛ ɡ
^fúj$	f uː j
^ihel$	i h ɛ l
^kék$	k eː k
^kurta$	k u r t ɒ
^pisze$	p i s ɛ
^tompa$	t o m p ɒ
^tusa$	t u ʃ ɒ
^vastag$	v ɒ ʃ t ɒ ɡ
^deszka$	d ɛ s k ɒ
^palánk$	p ɒ l aː n k
^ágál$	aː ɡ aː l
^hány$	h aː ɲ
^henceg$	h ɛ n t͡s ɛ ɡ
^hetvenkedik$	h ɛ t v ɛ n k ɛ d i k
^hivalkodik$	h i v ɒ l k o d i k
^kérkedik$	k eː r k ɛ d i k
^súg$	ʃ uː ɡ
^csille$	t͡ʃ i lː ɛ
^csónak$	t͡ʃ oː n ɒ k
^hajó$	h ɒ j oː
^sajka$	ʃ ɒ j k ɒ
^edény$	ɛ d eː ɲ
^tag$	t ɒ ɡ
^piros$	p i r o ʃ
^tetem$	t ɛ t ɛ m
^forr$	f o rː
^fő$	f øː
^lobog$	l o b o ɡ
^rotyog$	r o c o ɡ
^folytat$	f o j t ɒ t
^igyekezik$	i ɟ ɛ k ɛ z i k
^iparkodik$	i p ɒ r k o d i k
^rögtön$	r ø ɡ t ø n
^ruccan$	r u t͡sː ɒ n
^siet$	ʃ i ɛ t
^sürög$	ʃ y r ø ɡ
^szalad$	s ɒ l ɒ d
^trappol$	t r ɒ pː o l
^csont$	t͡ʃ o n t
^konc$	k o n t͡s
^könyv$	k ø ɲ v
^bagaria$	b ɒ ɡ ɒ r i ɒ
^cél$	t͡s eː l
^gránic$	ɡ r aː n i t͡s
^határ$	h ɒ t aː r
^perem$	p ɛ r ɛ m
^terminus$	t ɛ r m i n u ʃ
^főnök$	f øː n ø k
^góré$	ɡ oː r eː
^abajgat$	ɒ b ɒ j ɡ ɒ t
^bódít$	b oː d iː t
^habar$	h ɒ b ɒ r
^háborgat$	h aː b o r ɡ ɒ t
^háborít$	h aː b o r iː t
^hercehurcál$	h ɛ r t͡s ɛ h u r t͡s aː l
^kalapál$	k ɒ l ɒ p aː l
^kerget$	k ɛ r ɡ ɛ t
^noszogat$	n o s o ɡ ɒ t
^nyaggat$	ɲ ɒ ɡː ɒ t
^öl$	ø l
^teher$	t ɛ h ɛ r
^un$	u n
^vegzál$	v ɛ ɡ z aː l
^zakatol$	z ɒ k ɒ t o l
^zaklat$	z ɒ k l ɒ t
^bolt$	b o l t
^almárium$	ɒ l m aː r i u m
^bárka$	b aː r k ɒ
^láda$	l aː d ɒ
^pad$	p ɒ d
^szekrény$	s ɛ k r eː ɲ
^cenk$	t͡s ɛ n k
^férfi$	f eː r f i
^fika$	f i k ɒ
^fiók$	f i oː k
^fiú$	f i uː
^gyermek$	ɟ ɛ r m ɛ k
^pogonya$	p o ɡ o ɲ ɒ
^klapec$	k l ɒ p ɛ t͡s
^krapek$	k r ɒ p ɛ k
^kölyök$	k ø j ø k
^srác$	ʃ r aː t͡s
^surmó$	ʃ u r m oː
^agy$	ɒ ɟ
^ész$	eː s
^velő$	v ɛ l øː
^bog$	b o ɡ
^fiatal$	f i ɒ t ɒ l
^vív$	v iː v
^kenyér$	k ɛ ɲ eː r
^rács$	r aː t͡ʃ
^rombol$	r o m b o l
^roncsol$	r o n t͡ʃ o l
^tör$	t ø r
^törtet$	t ø r t ɛ t
^mell$	m ɛ lː
^nyű$	ɲ yː
^reped$	r ɛ p ɛ d
^tép$	t eː p
^begy$	b ɛ ɟ
^cici$	t͡s i t͡s i
^csecs$	t͡ʃ ɛ t͡ʃ
^emik$	ɛ m i k
^tömlő$	t ø m l øː
^leh$	l ɛ h
^lélek$	l eː l ɛ k
^pára$	p aː r ɒ
^szufla$	s u f l ɒ
^szuszma$	s u s m ɒ
^lélegzik$	l eː l ɛ ɡ z i k
^pih$	p i h
^pihen$	p i h ɛ n
^gát$	ɡ aː t
^halvány$	h ɒ l v aː ɲ
^vékony$	v eː k o ɲ
^iktat$	i k t ɒ t
^közvetít$	k ø z v ɛ t iː t
^vesz$	v ɛ s
^seper$	ʃ ɛ p ɛ r
^ara$	ɒ r ɒ
^atyafi$	ɒ c ɒ f i
^fivér$	f i v eː r
^pertu$	p ɛ r t u
^kanna$	k ɒ nː ɒ
^vödör$	v ø d ø r
^moccan$	m o t͡sː ɒ n
^mozog$	m o z o ɡ
^percen$	p ɛ r t͡s ɛ n
^emel$	ɛ m ɛ l
^épít$	eː p iː t
^fundál$	f u n d aː l
^magasztal$	m ɒ ɡ ɒ s t ɒ l
^rak$	r ɒ k
^bika$	b i k ɒ
^ökör$	ø k ø r
^táltos$	t aː l t o ʃ
^bála$	b aː l ɒ
^batyu$	b ɒ c u
^boly$	b o j
^bugyor$	b u ɟ o r
^bútor$	b uː t o r
^cula$	t͡s u l ɒ
^csombolyék$	t͡ʃ o m b o j eː k
^falka$	f ɒ l k ɒ
^folt$	f o l t
^göngyöleg$	ɡ ø n ɟ ø l ɛ ɡ
^gúnya$	ɡ uː ɲ ɒ
^köt$	k ø t
^kötet$	k ø t ɛ t
^motyó$	m o c oː
^nyaláb$	ɲ ɒ l aː b
^pakli$	p ɒ k l i
^tergenye$	t ɛ r ɡ ɛ ɲ ɛ
^tűr$	t yː r
^ver$	v ɛ r
^zajda$	z ɒ j d ɒ
^pörköl$	p ø r k ø l
^fortyan$	f o r c ɒ n
^perzsel$	p ɛ r ʒ ɛ l
^seft$	ʃ ɛ f t
^szakma$	s ɒ k m ɒ
^üzelem$	y z ɛ l ɛ m
^rádió$	r aː d i oː
^üzem$	y z ɛ m
^üzlet$	y z l ɛ t
^vállal$	v aː lː ɒ l
^vaj$	v ɒ j
^lependék$	l ɛ p ɛ n d eː k
^lepentyű$	l ɛ p ɛ n c yː
^lepke$	l ɛ p k ɛ
^lövöldék$	l ø v ø l d eː k
^pilla$	p i lː ɒ
^pillangó$	p i lː ɒ n ɡ oː
^pille$	p i lː ɛ
^csimbók$	t͡ʃ i m b oː k
^vált$	v aː l t
^szokotál$	s o k o t aː l
^hív$	h iː v
^kiált$	k i aː l t
^kodácsol$	k o d aː t͡ʃ o l
^hivatal$	h i v ɒ t ɒ l
^név$	n eː v
^szó$	s oː
^bérmál$	b eː r m aː l
^intéz$	i n t eː z
^mond$	m o n d
^jegy$	j ɛ ɟ
^mut$	m u t
^kápli$	k aː p l i
^sapka$	ʃ ɒ p k ɒ
^hord$	h o r d
^méz$	m eː z
^cica$	t͡s i t͡s ɒ
^lesbeteg$	l ɛ ʃ b ɛ t ɛ ɡ
^macska$	m ɒ t͡ʃ k ɒ
^ad$	ɒ d
^bocsát$	b o t͡ʃ aː t
^enged$	ɛ n ɡ ɛ d
^hagy$	h ɒ ɟ
^barlang$	b ɒ r l ɒ n ɡ
^kaverna$	k ɒ v ɛ r n ɒ
^lyuk$	j u k
^odor$	o d o r
^odú$	o d uː
^üreg$	y r ɛ ɡ
^szakad$	s ɒ k ɒ d
^vég$	v eː ɡ
^szeccel$	s ɛ t͡sː ɛ l
^szék$	s eː k
^ül$	y l
^fordít$	f o r d iː t
^választ$	v aː l ɒ s t
^betű$	b ɛ t yː
^karakter$	k ɒ r ɒ k t ɛ r
^abajog$	ɒ b ɒ j o ɡ
^csacsog$	t͡ʃ ɒ t͡ʃ o ɡ
^cseveg$	t͡ʃ ɛ v ɛ ɡ
^csiripel$	t͡ʃ i r i p ɛ l
^kaszinó$	k ɒ s i n oː
^karattyol$	k ɒ r ɒ cː o l
^ketyeg$	k ɛ c ɛ ɡ
^kuruttyol$	k u r u cː o l
^trafikál$	t r ɒ f i k aː l
^trécsel$	t r eː t͡ʃ ɛ l
^mulat$	m u l ɒ t
^szórakozik$	s oː r ɒ k o z i k
^olcsó$	o l t͡ʃ oː
^orca$	o r t͡s ɒ
^pofa$	p o f ɒ
^tügy$	t y ɟ
^pipi$	p i p i
^apró$	ɒ p r oː
^apród$	ɒ p r oː d
^béka$	b eː k ɒ
^cimbora$	t͡s i m b o r ɒ
^csemege$	t͡ʃ ɛ m ɛ ɡ ɛ
^csemete$	t͡ʃ ɛ m ɛ t ɛ
^csőcselék$	t͡ʃ øː t͡ʃ ɛ l eː k
^csürhe$	t͡ʃ y r h ɛ
^kölönc$	k ø l ø n t͡s
^puzsér$	p u ʒ eː r
^rügy$	r y ɟ
^sarjú$	ʃ ɒ r j uː
^szül$	s y l
^torongy$	t o r o n ɟ
^kondít$	k o n d iː t
^ajak$	ɒ j ɒ k
^áll$	aː lː
^néz$	n eː z
^horol$	h o r o l
^vág$	v aː ɡ
^kapa$	k ɒ p ɒ
^parókia$	p ɒ r oː k i ɒ
^templom$	t ɛ m p l o m
^abroncs$	ɒ b r o n t͡ʃ
^cirkalom$	t͡s i r k ɒ l o m
^karika$	k ɒ r i k ɒ
^kerék$	k ɛ r eː k
^kerül$	k ɛ r y l
^kör$	k ø r
^kög$	k ø ɡ
^perec$	p ɛ r ɛ t͡s
^csíp$	t͡ʃ iː p
^csór$	t͡ʃ oː r
^csülök$	t͡ʃ y l ø k
^köröm$	k ø r ø m
^agyag$	ɒ ɟ ɒ ɡ
^sár$	ʃ aː r
^sikér$	ʃ i k eː r
^tapasz$	t ɒ p ɒ s
^vályog$	v aː j o ɡ
^takarékos$	t ɒ k ɒ r eː k o ʃ
^takaros$	t ɒ k ɒ r o ʃ
^tiszta$	t i s t ɒ
^cement$	t͡s ɛ m ɛ n t
^pucol$	p u t͡s o l
^rámol$	r aː m o l
^pamacs$	p ɒ m ɒ t͡ʃ
^pemete$	p ɛ m ɛ t ɛ
^takarít$	t ɒ k ɒ r iː t
^agg$	ɒ ɡː
^agyafúrt$	ɒ ɟ ɒ f uː r t
^álnok$	aː l n o k
^csúf$	t͡ʃ uː f
^fonák$	f o n aː k
^furcsa$	f u r t͡ʃ ɒ
^furfang$	f u r f ɒ n ɡ
^huncut$	h u n t͡s u t
^rafinált$	r ɒ f i n aː l t
^ravasz$	r ɒ v ɒ s
^sód$	ʃ oː d
^ildomos$	i l d o m o ʃ
^okos$	o k o ʃ
^serény$	ʃ ɛ r eː ɲ
^hág$	h aː ɡ
^mászik$	m aː s i k
^tápászkodik$	t aː p aː s k o d i k
^anyag$	ɒ ɲ ɒ ɡ
^kelme$	k ɛ l m ɛ
^moher$	m o h ɛ r
^ruha$	r u h ɒ
^vitorla$	v i t o r l ɒ
^szőr$	s øː r
^szöveg$	s ø v ɛ ɡ
^textil$	t ɛ k s t i l
^katrinca$	k ɒ t r i n t͡s ɒ
^tesztemény$	t ɛ s t ɛ m eː ɲ
^dressz$	d r ɛ sː
^kosztüm$	k o s t y m
^mez$	m ɛ z
^öltözik$	ø l t ø z i k
^toalett$	t o ɒ l ɛ tː
^fregoli$	f r ɛ ɡ o l i
^könnyű$	k ø ɲː yː
^pacuha$	p ɒ t͡s u h ɒ
^felleg$	f ɛ lː ɛ ɡ
^homály$	h o m aː j
^köd$	k ø d
^cidri$	t͡s i d r i
^garabonciás$	ɡ ɒ r ɒ b o n t͡s i aː ʃ
^hideg$	h i d ɛ ɡ
^friss$	f r i ʃː
^hűvös$	h yː v ø ʃ
^sprőd$	ʃ p r øː d
^gallér$	ɡ ɒ lː eː r
^grabanc$	ɡ r ɒ b ɒ n t͡s
^nyak$	ɲ ɒ k
^násfa$	n aː ʃ f ɒ
^bonta$	b o n t ɒ
^iromba$	i r o m b ɒ
^tarka$	t ɒ r k ɒ
^búb$	b uː b
^címer$	t͡s iː m ɛ r
^fésű$	f eː ʃ yː
^fodor$	f o d o r
^gereben$	ɡ ɛ r ɛ b ɛ n
^ecsel$	ɛ t͡ʃ ɛ l
^gereblye$	ɡ ɛ r ɛ b j ɛ
^gázol$	ɡ aː z o l
^tér$	t eː r
^fartol$	f ɒ r t o l
^kaláka$	k ɒ l aː k ɒ
^kompánia$	k o m p aː n i ɒ
^koszorú$	k o s o r uː
^szalon$	s ɒ l o n
^tanya$	t ɒ ɲ ɒ
^tart$	t ɒ r t
^vegyít$	v ɛ ɟ iː t
^diskurzus$	d i ʃ k u r z u ʃ
^kollokvium$	k o lː o k v i u m
^fej$	f ɛ j
^kisüt$	k i ʃ y t
^közöl$	k ø z ø l
^rohog$	r o h o ɡ
^serít$	ʃ ɛ r iː t
^suhog$	ʃ u h o ɡ
^csák$	t͡ʃ aː k
^kuckó$	k u t͡s k oː
^sarok$	ʃ ɒ r o k
^szurdok$	s u r d o k
^vinkli$	v i n k l i
^zug$	z u ɡ
^egyenes$	ɛ ɟ ɛ n ɛ ʃ
^éljen$	eː l j ɛ n
^helyes$	h ɛ j ɛ ʃ
^kóser$	k oː ʃ ɛ r
^pont$	p o n t
^richtig$	r i h t i ɡ
^hurut$	h u r u t
^kahog$	k ɒ h o ɡ
^kákog$	k aː k o ɡ
^köhög$	k ø h ø ɡ
^olvas$	o l v ɒ ʃ
^szoroz$	s o r o z
^elv$	ɛ l v
^föld$	f ø l d
^ország$	o r s aː ɡ
^esd$	ɛ ʃ d
^esik$	ɛ ʃ i k
^fut$	f u t
^von$	v o n
^boci$	b o t͡s i
^tehén$	t ɛ h eː n
^ünő$	y n øː
^bölcső$	b ø l t͡ʃ øː
^hajcsi$	h ɒ j t͡ʃ i
^reng$	r ɛ n ɡ
^daru$	d ɒ r u
^csúszik$	t͡ʃ uː s i k
^kuttog$	k u tː o ɡ
^osont$	o ʃ o n t
^somfordál$	ʃ o m f o r d aː l
^sompolyodik$	ʃ o m p o j o d i k
^sompolyog$	ʃ o m p o j o ɡ
^sudamlik$	ʃ u d ɒ m l i k
^suttyan$	ʃ u cː ɒ n
^sédó$	ʃ eː d oː
^tompor$	t o m p o r
^bese$	b ɛ ʃ ɛ
^csóka$	t͡ʃ oː k ɒ
^kánya$	k aː ɲ ɒ
^varjú$	v ɒ r j uː
^köveköl$	k ø v ɛ k ø l
^kovákol$	k o v aː k o l
^nyivákol$	ɲ i v aː k o l
^pisszeg$	p i sː ɛ ɡ
^pusmog$	p u ʃ m o ɡ
^rí$	r iː
^rikácsol$	r i k aː t͡ʃ o l
^sír$	ʃ iː r
^pilács$	p i l aː t͡ʃ
^kakukk$	k ɒ k u kː
^billikom$	b i lː i k o m
^bokály$	b o k aː j
^csanak$	t͡ʃ ɒ n ɒ k
^kupa$	k u p ɒ
^kürt$	k y r t
^pohár$	p o h aː r
^serleg$	ʃ ɛ r l ɛ ɡ
^csajka$	t͡ʃ ɒ j k ɒ
^findzsa$	f i n d͡ʒ ɒ
^tálca$	t aː l t͡s ɒ
^csesz$	t͡ʃ ɛ s
^met$	m ɛ t
^ró$	r oː
^szab$	s ɒ b
^szel$	s ɛ l
^vés$	v eː ʃ
^eltökít$	ɛ l t ø k iː t
^mezgerél$	m ɛ z ɡ ɛ r eː l
^rongál$	r o n ɡ aː l
^sért$	ʃ eː r t
^árt$	aː r t
^gonosz$	ɡ o n o s
^kártékony$	k aː r t eː k o ɲ
^kár$	k aː r
^seb$	ʃ ɛ b
^nyers$	ɲ ɛ r ʃ
^boka$	b o k ɒ
^csörög$	t͡ʃ ø r ø ɡ
^dorombol$	d o r o m b o l
^lejt$	l ɛ j t
^lippen$	l i pː ɛ n
^rúg$	r uː ɡ
^szökik$	s ø k i k
^toboroz$	t o b o r o z
^toporzékol$	t o p o r z eː k o l
^sötét$	ʃ ø t eː t
^dúdol$	d uː d o l
^zúg$	z uː ɡ
^leány$	l ɛ aː ɲ
^nap$	n ɒ p
^bamba$	b ɒ m b ɒ
^kuka$	k u k ɒ
^meddő$	m ɛ dː øː
^süket$	ʃ y k ɛ t
^süsü$	ʃ y ʃ y
^édes$	eː d ɛ ʃ
^ravatal$	r ɒ v ɒ t ɒ l
^december$	d ɛ t͡s ɛ m b ɛ r
^dekorál$	d ɛ k o r aː l
^csök$	t͡ʃ ø k
^csüng$	t͡ʃ y n ɡ
^fogy$	f o ɟ
^lohad$	l o h ɒ d
^sápad$	ʃ aː p ɒ d
^züllik$	z y lː i k
^ment$	m ɛ n t
^véd$	v eː d
^atya$	ɒ c ɒ
^felség$	f ɛ l ʃ eː ɡ
^isten$	i ʃ t ɛ n
^terem$	t ɛ r ɛ m
^úr$	uː r
^masszív$	m ɒ sː iː v
^szorgos$	s o r ɡ o ʃ
^szoros$	s o r o ʃ
^tömérdek$	t ø m eː r d ɛ k
^tömör$	t ø m ø r
^zok$	z o k
^bont$	b o n t
^rücsköl$	r y t͡ʃ k ø l
^tékozol$	t eː k o z o l
^veszt$	v ɛ s t
^helyre$	h ɛ j r ɛ
^szer$	s ɛ r
^elpatkol$	ɛ l p ɒ t k o l
^gebed$	ɡ ɛ b ɛ d
^hal$	h ɒ l
^huny$	h u ɲ
^nyugszik$	ɲ u ɡ s i k
^szenved$	s ɛ n v ɛ d
^veszekedik$	v ɛ s ɛ k ɛ d i k
^hull$	h u lː
^különb$	k y l ø n b
^különben$	k y l ø n b ɛ n
^árok$	aː r o k
^ásvány$	aː ʃ v aː ɲ
^erge$	ɛ r ɡ ɛ
^gádor$	ɡ aː d o r
^kotyor$	k o c o r
^róna$	r oː n ɒ
^vápa$	v aː p ɒ
^verem$	v ɛ r ɛ m
^ás$	aː ʃ
^kotor$	k o t o r
^túr$	t uː r
^szorgalom$	s o r ɡ ɒ l o m
^gaz$	ɡ ɒ z
^kosz$	k o s
^koszmó$	k o s m oː
^maszat$	m ɒ s ɒ t
^mocsok$	m o t͡ʃ o k
^piszok$	p i s o k
^retek$	r ɛ t ɛ k
^rücsök$	r y t͡ʃ ø k
^szurok$	s u r o k
^cefet$	t͡s ɛ f ɛ t
^csatakos$	t͡ʃ ɒ t ɒ k o ʃ
^csoda$	t͡ʃ o d ɒ
^dancs$	d ɒ n t͡ʃ
^lepcses$	l ɛ p t͡ʃ ɛ ʃ
^locspocs$	l o t͡ʃ p o t͡ʃ
^loncsos$	l o n t͡ʃ o ʃ
^murcos$	m u r t͡s o ʃ
^pranda$	p r ɒ n d ɒ
^puruttya$	p u r u cː ɒ
^redves$	r ɛ d v ɛ ʃ
^reves$	r ɛ v ɛ ʃ
^roncos$	r o n t͡s o ʃ
^ronda$	r o n d ɒ
^rusnya$	r u ʃ ɲ ɒ
^rút$	r uː t
^susnya$	ʃ u ʃ ɲ ɒ
^szemét$	s ɛ m eː t
^szennyes$	s ɛ ɲː ɛ ʃ
^szurtos$	s u r t o ʃ
^szutykos$	s u c k o ʃ
^tajdok$	t ɒ j d o k
^enyészik$	ɛ ɲ eː s i k
^illik$	i lː i k
^kallódik$	k ɒ lː oː d i k
^kel$	k ɛ l
^szív$	s iː v
^tűnik$	t yː n i k
^dög$	d ø ɡ
^nehéz$	n ɛ h eː z
^nyavalya$	ɲ ɒ v ɒ j ɒ
^eledel$	ɛ l ɛ d ɛ l
^eleség$	ɛ l ɛ ʃ eː ɡ
^kaja$	k ɒ j ɒ
^korcsolya$	k o r t͡ʃ o j ɒ
^koszt$	k o s t
^bizgat$	b i z ɡ ɒ t
^habuckol$	h ɒ b u t͡s k o l
^interpellál$	i n t ɛ r p ɛ lː aː l
^zavar$	z ɒ v ɒ r
^bújik$	b uː j i k
^bukik$	b u k i k
^márt$	m aː r t
^szakaszt$	s ɒ k ɒ s t
^cihődik$	t͡s i h øː d i k
^cihelődik$	t͡s i h ɛ l øː d i k
^cselekedik$	t͡ʃ ɛ l ɛ k ɛ d i k
^csinál$	t͡ʃ i n aː l
^eszköz$	ɛ s k ø z
^pepecsel$	p ɛ p ɛ t͡ʃ ɛ l
^eb$	ɛ b
^fakó$	f ɒ k oː
^guba$	ɡ u b ɒ
^kutya$	k u c ɒ
^alak$	ɒ l ɒ k
^bábu$	b aː b u
^buba$	b u b ɒ
^váz$	v aː z
^ajtó$	ɒ j t oː
^porta$	p o r t ɒ
^alá$	ɒ l aː
^fityeg$	f i c ɛ ɡ
^le$	l ɛ
^hurcol$	h u r t͡s o l
^húz$	h uː z
^álom$	aː l o m
^iszik$	i s i k
^piál$	p i aː l
^dirigál$	d i r i ɡ aː l
^kanyarít$	k ɒ ɲ ɒ r iː t
^kéz$	k eː z
^kormány$	k o r m aː ɲ
^térít$	t eː r iː t
^utal$	u t ɒ l
^utasít$	u t ɒ ʃ iː t
^vezényel$	v ɛ z eː ɲ ɛ l
^vezet$	v ɛ z ɛ t
^kaptat$	k ɒ p t ɒ t
^megy$	m ɛ ɟ
^hajkurász$	h ɒ j k u r aː s
^téreget$	t eː r ɛ ɡ ɛ t
^csepp$	t͡ʃ ɛ pː
^cseppen$	t͡ʃ ɛ pː ɛ n
^ejt$	ɛ j t
^faré$	f ɒ r eː
^ösztövér$	ø s t ø v eː r
^száraz$	s aː r ɒ z
^töpped$	t ø pː ɛ d
^kacsa$	k ɒ t͡ʃ ɒ
^réce$	r eː t͡s ɛ
^ruca$	r u t͡s ɒ
^tóka$	t oː k ɒ
^por$	p o r
^fest$	f ɛ ʃ t
^sas$	ʃ ɒ ʃ
^fül$	f y l
^kagyló$	k ɒ ɟ l oː
^rög$	r ø ɡ
^kelet$	k ɛ l ɛ t
^burok$	b u r o k
^lakik$	l ɒ k i k
^párkány$	p aː r k aː ɲ
^kukó$	k u k oː
^mony$	m o ɲ
^tojik$	t o j i k
^nyolc$	ɲ o l t͡s
^nyolcvan$	ɲ o l t͡s v ɒ n
^könyök$	k ø ɲ ø k
^gorond$	ɡ o r o n d
^jávorszarvas$	j aː v o r s ɒ r v ɒ ʃ
^jelent$	j ɛ l ɛ n t
^hiú$	h i uː
^léha$	l eː h ɒ
^paraszt$	p ɒ r ɒ s t
^parlag$	p ɒ r l ɒ ɡ
^sivár$	ʃ i v aː r
^bütü$	b y t y
^farok$	f ɒ r o k
^finálé$	f i n aː l eː
^ómega$	oː m ɛ ɡ ɒ
^slussz$	ʃ l u sː
^szűnik$	s yː n i k
^tető$	t ɛ t øː
^utó$	u t oː
^ex$	ɛ k s
^bír$	b iː r
^visz$	v i s
^ellen$	ɛ lː ɛ n
^virul$	v i r u l
^emigráció$	ɛ m i ɡ r aː t͡s i oː
^sarkall$	ʃ ɒ r k ɒ lː
^ugrik$	u ɡ r i k
^est$	ɛ ʃ t
^vecsernye$	v ɛ t͡ʃ ɛ r ɲ ɛ
^szanaszét$	s ɒ n ɒ s eː t
^árgyélus$	aː r ɟ eː l u ʃ
^bal$	b ɒ l
^élhetetlen$	eː l h ɛ t ɛ t l ɛ n
^hamis$	h ɒ m i ʃ
^ördög$	ø r d ø ɡ
^drága$	d r aː ɡ ɒ
^gazdag$	ɡ ɒ z d ɒ ɡ
^kép$	k eː p
^személy$	s ɛ m eː j
^beszéd$	b ɛ s eː d
^mese$	m ɛ ʃ ɛ
^borul$	b o r u l
^hanyatlik$	h ɒ ɲ ɒ t l i k
^suvad$	ʃ u v ɒ d
^szotyog$	s o c o ɡ
^notórius$	n o t oː r i u ʃ
^család$	t͡ʃ ɒ l aː d
^cseléd$	t͡ʃ ɛ l eː d
^família$	f ɒ m iː l i ɒ
^galéria$	ɡ ɒ l eː r i ɒ
^generáció$	ɡ ɛ n ɛ r aː t͡s i oː
^ház$	h aː z
^pereputty$	p ɛ r ɛ p u cː
^messze$	m ɛ sː ɛ
^távol$	t aː v o l
^tova$	t o v ɒ
^boldog$	b o l d o ɡ
^busás$	b u ʃ aː ʃ
^pozsgás$	p o ʒ ɡ aː ʃ
^terepes$	t ɛ r ɛ p ɛ ʃ
^tömzsi$	t ø m ʒ i
^vaskos$	v ɒ ʃ k o ʃ
^zahin$	z ɒ h i n
^duci$	d u t͡s i
^pecsenye$	p ɛ t͡ʃ ɛ ɲ ɛ
^zsír$	ʒ iː r
^apa$	ɒ p ɒ
^após$	ɒ p oː ʃ
^dádé$	d aː d eː
^fater$	f ɒ t ɛ r
^papa$	p ɒ p ɒ
^tata$	t ɒ t ɒ
^dübög$	d y b ø ɡ
^dübörög$	d y b ø r ø ɡ
^hüppög$	h y pː ø ɡ
^iscsap$	i ʃ t͡ʃ ɒ p
^zászló$	z aː s l oː
^február$	f ɛ b r u aː r
^legel$	l ɛ ɡ ɛ l
^táplál$	t aː p l aː l
^tapasztal$	t ɒ p ɒ s t ɒ l
^gárgya$	ɡ aː r ɟ ɒ
^karó$	k ɒ r oː
^kert$	k ɛ r t
^nyék$	ɲ eː k
^rekesz$	r ɛ k ɛ s
^verőce$	v ɛ r øː t͡s ɛ
^porgolát$	p o r ɡ o l aː t
^rigya$	r i ɟ ɒ
^tífusz$	t iː f u s
^ötven$	ø t v ɛ n
^paci$	p ɒ t͡s i
^torol$	t o r o l
^tölt$	t ø l t
^talál$	t ɒ l aː l
^dupla$	d u p l ɒ
^elegáns$	ɛ l ɛ ɡ aː n ʃ
^fájin$	f aː j i n
^filigrán$	f i l i ɡ r aː n
^klassz$	k l ɒ sː
^lágy$	l aː ɟ
^sája$	ʃ aː j ɒ
^ujj$	u jː
^tűz$	t yː z
^elő$	ɛ l øː
^első$	ɛ l ʃ øː
^öt$	ø t
^sovány$	ʃ o v aː ɲ
^sík$	ʃ iː k
^lóg$	l oː ɡ
^menekedik$	m ɛ n ɛ k ɛ d i k
^menekül$	m ɛ n ɛ k y l
^barom$	b ɒ r o m
^csorda$	t͡ʃ o r d ɒ
^darab$	d ɒ r ɒ b
^nyáj$	ɲ aː j
^sereg$	ʃ ɛ r ɛ ɡ
^flastrom$	f l ɒ ʃ t r o m
^palló$	p ɒ lː oː
^pádimentum$	p aː d i m ɛ n t u m
^padlás$	p ɒ d l aː ʃ
^talap$	t ɒ l ɒ p
^származik$	s aː r m ɒ z i k
^kocsány$	k o t͡ʃ aː ɲ
^virág$	v i r aː ɡ
^légy$	l eː ɟ
^evez$	ɛ v ɛ z
^peszterkedik$	p ɛ s t ɛ r k ɛ d i k
^repül$	r ɛ p y l
^hab$	h ɒ b
^tajték$	t ɒ j t eː k
^abrak$	ɒ b r ɒ k
^élelem$	eː l ɛ l ɛ m
^bábó$	b aː b oː
^gyalog$	ɟ ɒ l o ɡ
^láb$	l aː b
^sukk$	ʃ u kː
^top$	t o p
^nyom$	ɲ o m
^hosszú$	h o sː uː
^litánia$	l i t aː n i ɒ
^homlok$	h o m l o k
^barbár$	b ɒ r b aː r
^idegen$	i d ɛ ɡ ɛ n
^pogány$	p o ɡ aː ɲ
^cser$	t͡ʃ ɛ r
^cserje$	t͡ʃ ɛ r j ɛ
^iserdő$	i ʃ ɛ r d øː
^fa$	f ɒ
^gyóta$	ɟ oː t ɒ
^kerek$	k ɛ r ɛ k
^lunka$	l u n k ɒ
^pagony$	p ɒ ɡ o ɲ
^ság$	ʃ aː ɡ
^vad$	v ɒ d
^feled$	f ɛ l ɛ d
^vét$	v eː t
^negyven$	n ɛ ɟ v ɛ n
^négy$	n eː ɟ
^róka$	r oː k ɒ
^fagy$	f ɒ ɟ
^gyors$	ɟ o r ʃ
^péntek$	p eː n t ɛ k
^barát$	b ɒ r aː t
^drusza$	d r u s ɒ
^hapsi$	h ɒ p ʃ i
^haver$	h ɒ v ɛ r
^koma$	k o m ɒ
^karima$	k ɒ r i m ɒ
^orom$	o r o m
^sövény$	ʃ ø v eː ɲ
^utol$	u t o l
^innét$	i nː eː t
^innen$	i nː ɛ n
^egy$	ɛ ɟ
^tele$	t ɛ l ɛ
^teljes$	t ɛ l j ɛ ʃ
^bőr$	b øː r
^prém$	p r eː m
^suba$	ʃ u b ɒ
^figura$	f i ɡ u r ɒ
^játék$	j aː t eː k
^kapu$	k ɒ p u
^szed$	s ɛ d
^szít$	s iː t
^vakar$	v ɒ k ɒ r
^bátor$	b aː t o r
^csendes$	t͡ʃ ɛ n d ɛ ʃ
^jámbor$	j aː m b o r
^lassú$	l ɒ ʃː uː
^szelíd$	s ɛ l iː d
^szende$	s ɛ n d ɛ
^akceptál$	ɒ k t͡s ɛ p t aː l
^fog$	f o ɡ
^fogad$	f o ɡ ɒ d
^lát$	l aː t
^ragad$	r ɒ ɡ ɒ d
^aprehendál$	ɒ p r ɛ h ɛ n d aː l
^nyer$	ɲ ɛ r
^tartóztat$	t ɒ r t oː z t ɒ t
^ajándék$	ɒ j aː n d eː k
^pomána$	p o m aː n ɒ
^báb$	b aː b
^csibe$	t͡ʃ i b ɛ
^görl$	ɡ ø r l
^jog$	j o ɡ
^jár$	j aː r
^lép$	l eː p
^arany$	ɒ r ɒ ɲ
^domínium$	d o m iː n i u m
^igyól$	i ɟ oː l
^jó$	j oː
^csecse$	t͡ʃ ɛ t͡ʃ ɛ
^csicsás$	t͡ʃ i t͡ʃ aː ʃ
^csinos$	t͡ʃ i n o ʃ
^delikát$	d ɛ l i k aː t
^idomos$	i d o m o ʃ
^komót$	k o m oː t
^nyalka$	ɲ ɒ l k ɒ
^liba$	l i b ɒ
^lúd$	l uː d
^ed$	ɛ d
^gabona$	ɡ ɒ b o n ɒ
^láger$	l aː ɡ ɛ r
^bába$	b aː b ɒ
^banya$	b ɒ ɲ ɒ
^mama$	m ɒ m ɒ
^muter$	m u t ɛ r
^nyanya$	ɲ ɒ ɲ ɒ
^ük$	y k
^fű$	f yː
^mező$	m ɛ z øː
^pázsit$	p aː ʒ i t
^kasza$	k ɒ s ɒ
^láz$	l aː z
^lt$	l t
^lok$	l o k
^rét$	r eː t
^semlyék$	ʃ ɛ m j eː k
^tanórok$	t ɒ n oː r o k
^gödör$	ɡ ø d ø r
^koporsó$	k o p o r ʃ oː
^zöld$	z ø l d
^szür$	s y r
^epe$	ɛ p ɛ
^nyekeg$	ɲ ɛ k ɛ ɡ
^nyög$	ɲ ø ɡ
^reg$	r ɛ ɡ
^sóhajt$	ʃ oː h ɒ j t
^vernyog$	v ɛ r ɲ o ɡ
^vinnyog$	v i ɲː o ɡ
^szérű$	s eː r yː
^talaj$	t ɒ l ɒ j
^tel$	t ɛ l
^telek$	t ɛ l ɛ k
^nő$	n øː
^örök$	ø r ø k
^kém$	k eː m
^őrs$	øː r ʃ
^poszt$	p o s t
^silbak$	ʃ i l b ɒ k
^strázsa$	ʃ t r aː ʒ ɒ
^várta$	v aː r t ɒ
^pasasér$	p ɒ ʃ ɒ ʃ eː r
^fegyver$	f ɛ ɟ v ɛ r
^mordály$	m o r d aː j
^pirók$	p i r oː k
^zákány$	z aː k aː ɲ
^oldal$	o l d ɒ l
^állapik$	aː lː ɒ p i k
^árestál$	aː r ɛ ʃ t aː l
^stoppol$	ʃ t o pː o l
^tartózkodik$	t ɒ r t oː z k o d i k
^pracli$	p r ɒ t͡s l i
^bóda$	b oː d ɒ
^káva$	k aː v ɒ
^nyél$	ɲ eː l
^szár$	s aː r
^akaszt$	ɒ k ɒ s t
^függ$	f y ɡː
^csüggeszt$	t͡ʃ y ɡː ɛ s t
^passzíroz$	p ɒ sː iː r o z
^történik$	t ø r t eː n i k
^mázli$	m aː z l i
^szerencse$	s ɛ r ɛ n t͡ʃ ɛ
^acintos$	ɒ t͡s i n t o ʃ
^kemény$	k ɛ m eː ɲ
^komor$	k o m o r
^merev$	m ɛ r ɛ v
^szilárd$	s i l aː r d
^szívós$	s iː v oː ʃ
^alig$	ɒ l i ɡ
^csak$	t͡ʃ ɒ k
^éppen$	eː pː ɛ n
^nyúl$	ɲ uː l
^tapsifüles$	t ɒ p ʃ i f y l ɛ ʃ
^ugrifüles$	u ɡ r i f y l ɛ ʃ
^murva$	m u r v ɒ
^széna$	s eː n ɒ
^illuminál$	i lː u m i n aː l
^ő$	øː
^ön$	ø n
^vivát$	v i v aː t
^konty$	k o n c
^taraj$	t ɒ r ɒ j
^egész$	ɛ ɡ eː s
^épkézláb$	eː p k eː z l aː b
^józan$	j oː z ɒ n
^bokor$	b o k o r
^csokor$	t͡ʃ o k o r
^csukorék$	t͡ʃ u k o r eː k
^domb$	d o m b
^garmada$	ɡ ɒ r m ɒ d ɒ
^had$	h ɒ d
^halmazat$	h ɒ l m ɒ z ɒ t
^hancsik$	h ɒ n t͡ʃ i k
^hegy$	h ɛ ɟ
^kupac$	k u p ɒ t͡s
^máglya$	m aː ɡ j ɒ
^paksaméta$	p ɒ k ʃ ɒ m eː t ɒ
^prizma$	p r i z m ɒ
^róta$	r oː t ɒ
^tábor$	t aː b o r
^tömeg$	t ø m ɛ ɡ
^hall$	h ɒ lː
^hallgat$	h ɒ lː ɡ ɒ t
^neszel$	n ɛ s ɛ l
^pejsli$	p ɛ j ʃ l i
^hő$	h øː
^súly$	ʃ uː j
^zokon$	z o k o n
^csánk$	t͡ʃ aː n k
^eminencia$	ɛ m i n ɛ n t͡s i ɒ
^fenség$	f ɛ n ʃ eː ɡ
^magas$	m ɒ ɡ ɒ ʃ
^orr$	o rː
^segéd$	ʃ ɛ ɡ eː d
^óv$	oː v
^helyett$	h ɛ j ɛ tː
^ide$	i d ɛ
^ihol$	i h o l
^ihon$	i h o n
^itt$	i tː
^enyeget$	ɛ ɲ ɛ ɡ ɛ t
^rejt$	r ɛ j t
^sikkaszt$	ʃ i kː ɒ s t
^bujt$	b u j t
^dug$	d u ɡ
^temet$	t ɛ m ɛ t
^fel$	f ɛ l
^sudár$	ʃ u d aː r
^tulipiros$	t u l i p i r o ʃ
^fenn$	f ɛ nː
^fölül$	f ø l y l
^csúp$	t͡ʃ uː p
^döngöl$	d ø n ɡ ø l
^gyűr$	ɟ yː r
^mart$	m ɒ r t
^part$	p ɒ r t
^ponk$	p o n k
^ség$	ʃ eː ɡ
^torbágy$	t o r b aː ɟ
^bánt$	b aː n t
^késik$	k eː ʃ i k
^kardalészába$	k ɒ r d ɒ l eː s aː b ɒ
^tipli$	t i p l i
^haza$	h ɒ z ɒ
^hon$	h o n
^pátria$	p aː t r i ɒ
^otthon$	o tː h o n
^nektár$	n ɛ k t aː r
^bezzeg$	b ɛ zː ɛ ɡ
^bökken$	b ø kː ɛ n
^cibak$	t͡s i b ɒ k
^csáklya$	t͡ʃ aː k j ɒ
^csat$	t͡ʃ ɒ t
^gamó$	ɡ ɒ m oː
^kacs$	k ɒ t͡ʃ
^kajács$	k ɒ j aː t͡ʃ
^kajkó$	k ɒ j k oː
^kallantyú$	k ɒ lː ɒ n c uː
^kampó$	k ɒ m p oː
^kankalék$	k ɒ n k ɒ l eː k
^kankó$	k ɒ n k oː
^satu$	ʃ ɒ t u
^duda$	d u d ɒ
^szarv$	s ɒ r v
^trombita$	t r o m b i t ɒ
^tülök$	t y l ø k
^kabala$	k ɒ b ɒ l ɒ
^ló$	l oː
^pej$	p ɛ j
^mokány$	m o k aː ɲ
^cerkó$	t͡s ɛ r k oː
^be$	b ɛ
^hogy$	h o ɟ
^holyan$	h o j ɒ n
^ki$	k i
^mekkora$	m ɛ kː o r ɒ
^mely$	m ɛ j
^mint$	m i n t
^monnal$	m o nː ɒ l
^mennyi$	m ɛ ɲː i
^bömböl$	b ø m b ø l
^huhogat$	h u h o ɡ ɒ t
^nyafog$	ɲ ɒ f o ɡ
^nyerít$	ɲ ɛ r iː t
^ordít$	o r d iː t
^riaszkodik$	r i ɒ s k o d i k
^sí$	ʃ iː
^süvölt$	ʃ y v ø l t
^száz$	s aː z
^hajhász$	h ɒ j h aː s
^társ$	t aː r ʃ
^én$	eː n
^saját$	ʃ ɒ j aː t
^jég$	j eː ɡ
^képlet$	k eː p l ɛ t
^példa$	p eː l d ɒ
^emendál$	ɛ m ɛ n d aː l
^igaz$	i ɡ ɒ z
^igéz$	i ɡ eː z
^jobb$	j o bː
^előtt$	ɛ l øː tː
^hasztalan$	h ɒ s t ɒ l ɒ n
^hiányos$	h i aː ɲ o ʃ
^potyára$	p o c aː r ɒ
^hiába$	h i aː b ɒ
^hatvány$	h ɒ t v aː ɲ
^hízik$	h iː z i k
^terjed$	t ɛ r j ɛ d
^azonban$	ɒ z o n b ɒ n
^azonnal$	ɒ z o nː ɒ l
^ezennel$	ɛ z ɛ nː ɛ l
^ingyen$	i n ɟ ɛ n
^íz$	iː z
^jelen$	j ɛ l ɛ n
^közvetetlen$	k ø z v ɛ t ɛ t l ɛ n
^majdan$	m ɒ j d ɒ n
^meleg$	m ɛ l ɛ ɡ
^menten$	m ɛ n t ɛ n
^tüstént$	t y ʃ t eː n t
^üstöllést$	y ʃ t ø lː eː ʃ t
^int$	i n t
^invitál$	i n v i t aː l
^vas$	v ɒ ʃ
^önt$	ø n t
^szt$	s t
^kereszt$	k ɛ r ɛ s t
^objektum$	o b j ɛ k t u m
^rózsa$	r oː ʒ ɒ
^szemlél$	s ɛ m l eː l
^január$	j ɒ n u aː r
^zötyköl$	z ø c k ø l
^egyezik$	ɛ ɟ ɛ z i k
^öröm$	ø r ø m
^víg$	v iː ɡ
^július$	j uː l i u ʃ
^fincol$	f i n t͡s o l
^tombol$	t o m b o l
^június$	j uː n i u ʃ
^katlan$	k ɒ t l ɒ n
^kazán$	k ɒ z aː n
^kondér$	k o n d eː r
^potyol$	p o c o l
^rop$	r o p
^tapot$	t ɒ p o t
^tipor$	t i p o r
^likvidál$	l i k v i d aː l
^veszejt$	v ɛ s ɛ j t
^csín$	t͡ʃ iː n
^faj$	f ɒ j
^fajta$	f ɒ j t ɒ
^felekezet$	f ɛ l ɛ k ɛ z ɛ t
^típus$	t iː p u ʃ
^tónus$	t oː n u ʃ
^király$	k i r aː j
^ápol$	aː p o l
^csókol$	t͡ʃ oː k o l
^hagyap$	h ɒ ɟ ɒ p
^szopik$	s o p i k
^térd$	t eː r d
^kés$	k eː ʃ
^kusztora$	k u s t o r ɒ
^dörög$	d ø r ø ɡ
^kocog$	k o t͡s o ɡ
^koltog$	k o l t o ɡ
^pall$	p ɒ lː
^paskol$	p ɒ ʃ k o l
^bojt$	b o j t
^buckó$	b u t͡s k oː
^bunkó$	b u n k oː
^butykó$	b u c k oː
^bütyök$	b y c ø k
^csögbog$	t͡ʃ ø ɡ b o ɡ
^csömbölyék$	t͡ʃ ø m b ø j eː k
^gomb$	ɡ o m b
^göb$	ɡ ø b
^görcs$	ɡ ø r t͡ʃ
^pöfeteg$	p ø f ɛ t ɛ ɡ
^hágcsó$	h aː ɡ t͡ʃ oː
^lábító$	l aː b iː t oː
^rektor$	r ɛ k t o r
^létra$	l eː t r ɒ
^taroglya$	t ɒ r o ɡ j ɒ
^záp$	z aː p
^konstrukció$	k o n ʃ t r u k t͡s i oː
^teknő$	t ɛ k n øː
^strand$	ʃ t r ɒ n d
^tenger$	t ɛ n ɡ ɛ r
^tó$	t oː
^nyelv$	ɲ ɛ l v
^döcög$	d ø t͡s ø ɡ
^kacag$	k ɒ t͡s ɒ ɡ
^nevet$	n ɛ v ɛ t
^visít$	v i ʃ iː t
^csatara$	t͡ʃ ɒ t ɒ r ɒ
^tosz$	t o s
^tüntet$	t y n t ɛ t
^vet$	v ɛ t
^alamuszi$	ɒ l ɒ m u s i
^lajhár$	l ɒ j h aː r
^langaléta$	l ɒ n ɡ ɒ l eː t ɒ
^lanyha$	l ɒ ɲ h ɒ
^lomha$	l o m h ɒ
^lusta$	l u ʃ t ɒ
^ostoba$	o ʃ t o b ɒ
^pimasz$	p i m ɒ s
^renyhe$	r ɛ ɲ h ɛ
^rest$	r ɛ ʃ t
^slampet$	ʃ l ɒ m p ɛ t
^totyakos$	t o c ɒ k o ʃ
^trampli$	t r ɒ m p l i
^trehány$	t r ɛ h aː ɲ
^tunya$	t u ɲ ɒ
^dundi$	d u n d i
^henye$	h ɛ ɲ ɛ
^laza$	l ɒ z ɒ
^málé$	m aː l eː
^poshad$	p o ʃ h ɒ d
^rothad$	r o t h ɒ d
^csá$	t͡ʃ aː
^visel$	v i ʃ ɛ l
^idéz$	i d eː z
^lap$	l ɒ p
^lapu$	l ɒ p u
^levél$	l ɛ v eː l
^bőrönd$	b øː r ø n d
^harisnya$	h ɒ r i ʃ ɲ ɒ
^szíj$	s iː j
^árva$	aː r v ɒ
^özvegy$	ø z v ɛ ɟ
^puszta$	p u s t ɒ
^ín$	iː n
^nyal$	ɲ ɒ l
^borít$	b o r iː t
^fed$	f ɛ d
^kúp$	k uː p
^sátor$	ʃ aː t o r
^kupak$	k u p ɒ k
^sóder$	ʃ oː d ɛ r
^tészta$	t eː s t ɒ
^dől$	d øː l
^fekszik$	f ɛ k s i k
^hever$	h ɛ v ɛ r
^gyújt$	ɟ uː j t
^fém$	f eː m
^fény$	f eː ɲ
^villany$	v i lː ɒ ɲ
^vigály$	v i ɡ aː j
^línea$	l iː n ɛ ɒ
^vonal$	v o n ɒ l
^vonat$	v o n ɒ t
^száj$	s aː j
^máj$	m aː j
^sérvés$	ʃ eː r v eː ʃ
^becs$	b ɛ t͡ʃ
^kóbor$	k oː b o r
^nyűg$	ɲ yː ɡ
^sarzsi$	ʃ ɒ r ʒ i
^ándung$	aː n d u n ɡ
^gusztus$	ɡ u s t u ʃ
^kedv$	k ɛ d v
^kény$	k eː ɲ
^íme$	iː m ɛ
^isa$	i ʃ ɒ
^nám$	n aː m
^spekulál$	ʃ p ɛ k u l aː l
^guberál$	ɡ u b ɛ r aː l
^keres$	k ɛ r ɛ ʃ
^kutyul$	k u c u l
^tetű$	t ɛ t yː
^szerelem$	s ɛ r ɛ l ɛ m
^alattomban$	ɒ l ɒ tː o m b ɒ n
^lent$	l ɛ n t
^kontinens$	k o n t i n ɛ n ʃ
^szárazföld$	s aː r ɒ z f ø l d
^üt$	y t
^bosszant$	b o sː ɒ n t
^hergel$	h ɛ r ɡ ɛ l
^szutyongat$	s u c o n ɡ ɒ t
^ember$	ɛ m b ɛ r
^gazda$	ɡ ɒ z d ɒ
^manusz$	m ɒ n u s
^pantalló$	p ɒ n t ɒ lː oː
^szivar$	s i v ɒ r
^március$	m aː r t͡s i u ʃ
^majális$	m ɒ j aː l i ʃ
^május$	m aː j u ʃ
^érez$	eː r ɛ z
^ráció$	r aː t͡s i oː
^tartalom$	t ɒ r t ɒ l o m
^mér$	m eː r
^mérsékel$	m eː r ʃ eː k ɛ l
^hús$	h uː ʃ
^dózis$	d oː z i ʃ
^kanafória$	k ɒ n ɒ f oː r i ɒ
^kantaír$	k ɒ n t ɒ iː r
^receptum$	r ɛ t͡s ɛ p t u m
^pedz$	p ɛ d͡z
^treffel$	t r ɛ fː ɛ l
^forraszt$	f o rː ɒ s t
^csiricsáré$	t͡ʃ i r i t͡ʃ aː r eː
^dévaj$	d eː v ɒ j
^hír$	h iː r
^kolomp$	k o l o m p
^krónika$	k r oː n i k ɒ
^posta$	p o ʃ t ɒ
^közös$	k ø z ø ʃ
^dél$	d eː l
^kellőközép$	k ɛ lː øː k ø z eː p
^köz$	k ø z
^közép$	k ø z eː p
^médium$	m eː d i u m
^tej$	t ɛ j
^elme$	ɛ l m ɛ
^koponya$	k o p o ɲ ɒ
^tükör$	t y k ø r
^bűn$	b yː n
^gáncs$	ɡ aː n t͡ʃ
^gikszer$	ɡ i k s ɛ r
^ránc$	r aː n t͡s
^hétfő$	h eː t f øː
^bigyó$	b i ɟ oː
^dohány$	d o h aː ɲ
^érc$	eː r t͡s
^fakultás$	f ɒ k u l t aː ʃ
^korpa$	k o r p ɒ
^lóvé$	l oː v eː
^mammon$	m ɒ mː o n
^pénz$	p eː n z
^hó$	h oː
^hónap$	h oː n ɒ p
^hold$	h o l d
^berek$	b ɛ r ɛ k
^láp$	l aː p
^libeg$	l i b ɛ ɡ
^ragya$	r ɒ ɟ ɒ
^csimasz$	t͡ʃ i m ɒ s
^szúnyog$	s uː ɲ o ɡ
^anya$	ɒ ɲ ɒ
^rez$	r ɛ z
^isegér$	i ʃ ɛ ɡ eː r
^pocok$	p o t͡s o k
^bajusz$	b ɒ j u s
^etyepetye$	ɛ c ɛ p ɛ c ɛ
^kamatyol$	k ɒ m ɒ c o l
^olvaszt$	o l v ɒ s t
^inog$	i n o ɡ
^lükög$	l y k ø ɡ
^kása$	k aː ʃ ɒ
^massza$	m ɒ sː ɒ
^nyák$	ɲ aː k
^pempő$	p ɛ m p øː
^pép$	p eː p
^puliszka$	p u l i s k ɒ
^purga$	p u r ɡ ɒ
^tokány$	t o k aː ɲ
^gomba$	ɡ o m b ɒ
^kalap$	k ɒ l ɒ p
^csóró$	t͡ʃ oː r oː
^csupasz$	t͡ʃ u p ɒ s
^csurdé$	t͡ʃ u r d eː
^meztelen$	m ɛ z t ɛ l ɛ n
^purdé$	p u r d eː
^szirt$	s i r t
^tarkó$	t ɒ r k oː
^keskeny$	k ɛ ʃ k ɛ ɲ
^szálka$	s aː l k ɒ
^szűk$	s yː k
^feszes$	f ɛ s ɛ ʃ
^fojt$	f o j t
^gyakor$	ɟ ɒ k o r
^gyakran$	ɟ ɒ k r ɒ n
^köldök$	k ø l d ø k
^közel$	k ø z ɛ l
^rokon$	r o k o n
^torok$	t o r o k
^fészek$	f eː s ɛ k
^háló$	h aː l oː
^necc$	n ɛ t͡sː
^rece$	r ɛ t͡s ɛ
^soha$	ʃ o h ɒ
^ifjú$	i f j uː
^novella$	n o v ɛ lː ɒ
^fattyú$	f ɒ cː uː
^kívül$	k iː v y l
^mellett$	m ɛ lː ɛ tː
^éjjel$	eː jː ɛ l
^éjszaka$	eː j s ɒ k ɒ
^kilenc$	k i l ɛ n t͡s
^kilencven$	k i l ɛ n t͡s v ɛ n
^balhé$	b ɒ l h eː
^csárma$	t͡ʃ aː r m ɒ
^csinnadratta$	t͡ʃ i nː ɒ d r ɒ tː ɒ
^echó$	ɛ h oː
^kravall$	k r ɒ v ɒ lː
^koncert$	k o n t͡s ɛ r t
^lárma$	l aː r m ɒ
^muri$	m u r i
^patália$	p ɒ t aː l i ɒ
^ramazúri$	r ɒ m ɒ z uː r i
^rumli$	r u m l i
^zaj$	z ɒ j
^zsinagóga$	ʒ i n ɒ ɡ oː ɡ ɒ
^zsinat$	ʒ i n ɒ t
^hurok$	h u r o k
^makk$	m ɒ kː
^tőr$	t øː r
^észak$	eː s ɒ k
^ormány$	o r m aː ɲ
^sem$	ʃ ɛ m
^ismer$	i ʃ m ɛ r
^sejdít$	ʃ ɛ j d iː t
^november$	n o v ɛ m b ɛ r
^ma$	m ɒ
^most$	m o ʃ t
^október$	o k t oː b ɛ r
^bűz$	b yː z
^füst$	f y ʃ t
^illat$	i lː ɒ t
^szag$	s ɒ ɡ
^szesz$	s ɛ s
^ekképpen$	ɛ kː eː pː ɛ n
^tehát$	t ɛ h aː t
^úgy$	uː ɟ
^olaj$	o l ɒ j
^aggastyán$	ɒ ɡː ɒ ʃ c aː n
^avas$	ɒ v ɒ ʃ
^canga$	t͡s ɒ n ɡ ɒ
^ó$	oː
^ósdi$	oː ʃ d i
^rég$	r eː ɡ
^vén$	v eː n
^veterán$	v ɛ t ɛ r aː n
^alt$	ɒ l t
^rukkol$	r u kː o l
^verdung$	v ɛ r d u n ɡ
^tár$	t aː r
^áperte$	aː p ɛ r t ɛ
^expressz$	ɛ k s p r ɛ sː
^frankó$	f r ɒ n k oː
^avagy$	ɒ v ɒ ɟ
^vagy$	v ɒ ɟ
^vagyis$	v ɒ ɟ i ʃ
^egyéb$	ɛ ɟ eː b
^más$	m aː ʃ
^másod$	m aː ʃ o d
^bagoly$	b ɒ ɡ o j
^szín$	s iː n
^hím$	h iː m
^ír$	iː r
^pingál$	p i n ɡ aː l
^karcol$	k ɒ r t͡s o l
^rajzol$	r ɒ j z o l
^cikkely$	t͡s i kː ɛ j
^ciklus$	t͡s i k l u ʃ
^osztály$	o s t aː j
^parti$	p ɒ r t i
^pászma$	p aː s m ɒ
^pászta$	p aː s t ɒ
^remek$	r ɛ m ɛ k
^szakasz$	s ɒ k ɒ s
^múlik$	m uː l i k
^el$	ɛ l
^félre$	f eː l r ɛ
^furt$	f u r t
^ösvény$	ø ʃ v eː ɲ
^út$	uː t
^sikátor$	ʃ i k aː t o r
^fazon$	f ɒ z o n
^forma$	f o r m ɒ
^minta$	m i n t ɒ
^modell$	m o d ɛ lː
^mustra$	m u ʃ t r ɒ
^patron$	p ɒ t r o n
^ráma$	r aː m ɒ
^sablon$	ʃ ɒ b l o n
^mancs$	m ɒ n t͡ʃ
^fizet$	f i z ɛ t
^jatt$	j ɒ tː
^nemz$	n ɛ m z
^durva$	d u r v ɒ
^kolc$	k o l t͡s
^sügér$	ʃ y ɡ eː r
^buksi$	b u k ʃ i
^fráter$	f r aː t ɛ r
^lény$	l eː ɲ
^császár$	t͡ʃ aː s aː r
^egzisztencia$	ɛ ɡ z i s t ɛ n t͡s i ɒ
^egyén$	ɛ ɟ eː n
^elem$	ɛ l ɛ m
^perszóna$	p ɛ r s oː n ɒ
^szerdék$	s ɛ r d eː k
^tárgy$	t aː r ɟ
^doktor$	d o k t o r
^fizikus$	f i z i k u ʃ
^orvos$	o r v o ʃ
^fejt$	f ɛ j t
^ábráz$	aː b r aː z
^tabló$	t ɒ b l oː
^flekk$	f l ɛ kː
^cika$	t͡s i k ɒ
^disznó$	d i s n oː
^sertés$	ʃ ɛ r t eː ʃ
^csuka$	t͡ʃ u k ɒ
^fejal$	f ɛ j ɒ l
^párna$	p aː r n ɒ
^vánkos$	v aː n k o ʃ
^bánya$	b aː ɲ ɒ
^kotú$	k o t uː
^hely$	h ɛ j
^lokál$	l o k aː l
^blatt$	b l ɒ tː
^kontráz$	k o n t r aː z
^ágrólszakadt$	aː ɡ r oː l s ɒ k ɒ d t
^pőre$	p øː r ɛ
^rideg$	r i d ɛ ɡ
^sóher$	ʃ oː h ɛ r
^árbóc$	aː r b oː t͡s
^azsag$	ɒ ʒ ɒ ɡ
^csiatag$	t͡ʃ i ɒ t ɒ ɡ
^dorong$	d o r o n ɡ
^gém$	ɡ eː m
^korlát$	k o r l aː t
^lésza$	l eː s ɒ
^pózna$	p oː z n ɒ
^fazék$	f ɒ z eː k
^véndely$	v eː n d ɛ j
^lomp$	l o m p
^szatyor$	s ɒ c o r
^szütyő$	s y c øː
^tarsoly$	t ɒ r ʃ o j
^zacskó$	z ɒ t͡ʃ k oː
^zsák$	ʒ aː k
^zseb$	ʒ ɛ b
^dönt$	d ø n t
^özön$	ø z ø n
^zúdít$	z uː d iː t
^bot$	b o t
^hatály$	h ɒ t aː j
^hatalom$	h ɒ t ɒ l o m
^rengeteg$	r ɛ n ɡ ɛ t ɛ ɡ
^busa$	b u ʃ ɒ
^dezentor$	d ɛ z ɛ n t o r
^divat$	d i v ɒ t
^kan$	k ɒ n
^kész$	k eː s
^gardíroz$	ɡ ɒ r d iː r o z
^konzervál$	k o n z ɛ r v aː l
^nyomorgat$	ɲ o m o r ɡ ɒ t
^díj$	d iː j
^ösztöndíj$	ø s t ø n d iː j
^pálya$	p aː j ɒ
^alkot$	ɒ l k o t
^farag$	f ɒ r ɒ ɡ
^gyárt$	ɟ aː r t
^produkál$	p r o d u k aː l
^állítmány$	aː lː iː t m aː ɲ
^ajánl$	ɒ j aː n l
^ígér$	iː ɡ eː r
^párt$	p aː r t
^támad$	t aː m ɒ d
^nyújt$	ɲ uː j t
^vonatkozik$	v o n ɒ t k o z i k
^vonul$	v o n u l
^bök$	b ø k
^dob$	d o b
^döf$	d ø f
^fúl$	f uː l
^lóbál$	l oː b aː l
^lök$	l ø k
^öklel$	ø k l ɛ l
^szúr$	s uː r
^taszít$	t ɒ s iː t
^tuszkol$	t u s k o l
^vonz$	v o n z
^ernyő$	ɛ r ɲ øː
^eső$	ɛ ʃ øː
^írisz$	iː r i s
^kégy$	k eː ɟ
^szivárvány$	s i v aː r v aː ɲ
^nevel$	n ɛ v ɛ l
^burkus$	b u r k u ʃ
^csúnya$	t͡ʃ uː ɲ ɒ
^drasztikus$	d r ɒ s t i k u ʃ
^röhög$	r ø h ø ɡ
^al$	ɒ l
^alap$	ɒ l ɒ p
^fenék$	f ɛ n eː k
^gyökér$	ɟ ø k eː r
^ellát$	ɛ lː aː t
^ért$	eː r t
^észrevesz$	eː s r ɛ v ɛ s
^gyógyul$	ɟ oː ɟ u l
^ocsúdik$	o t͡ʃ uː d i k
^bíbor$	b iː b o r
^vörös$	v ø r ø ʃ
^riska$	r i ʃ k ɒ
^emlékezik$	ɛ m l eː k ɛ z i k
^eszmél$	ɛ s m eː l
^menik$	m ɛ n i k
^lézeng$	l eː z ɛ n ɡ
^fakad$	f ɒ k ɒ d
^gyeplő$	ɟ ɛ p l øː
^kantár$	k ɒ n t aː r
^kötény$	k ø t eː ɲ
^paszomány$	p ɒ s o m aː ɲ
^pendely$	p ɛ n d ɛ j
^szalag$	s ɒ l ɒ ɡ
^bő$	b øː
^dús$	d uː ʃ
^duska$	d u ʃ k ɒ
^impérium$	i m p eː r i u m
^gyűrű$	ɟ yː r yː
^csilingel$	t͡ʃ i l i n ɡ ɛ l
^öblít$	ø b l iː t
^maráz$	m ɒ r aː z
^csorog$	t͡ʃ o r o ɡ
^utca$	u t t͡s ɒ
^bőg$	b øː ɡ
^búg$	b uː ɡ
^mormol$	m o r m o l
^morog$	m o r o ɡ
^pozsog$	p o ʒ o ɡ
^sikolt$	ʃ i k o l t
^visong$	v i ʃ o n ɡ
^födém$	f ø d eː m
^kakas$	k ɒ k ɒ ʃ
^csíra$	t͡ʃ iː r ɒ
^tő$	t øː
^korhad$	k o r h ɒ d
^peshed$	p ɛ ʃ h ɛ d
^rökönyül$	r ø k ø ɲ y l
^gombolyag$	ɡ o m b o j ɒ ɡ
^gömbölyű$	ɡ ø m b ø j yː
^görög$	ɡ ø r ø ɡ
^csiszol$	t͡ʃ i s o l
^dörzsöl$	d ø r ʒ ø l
^firkál$	f i r k aː l
^karmol$	k ɒ r m o l
^ken$	k ɛ n
^reszel$	r ɛ s ɛ l
^riszál$	r i s aː l
^rüh$	r y h
^súrol$	ʃ uː r o l
^szil$	s i l
^töröl$	t ø r ø l
^dominál$	d o m i n aː l
^bíró$	b iː r oː
^illa$	i lː ɒ
^nyargal$	ɲ ɒ r ɡ ɒ l
^pereg$	p ɛ r ɛ ɡ
^inal$	i n ɒ l
^iramik$	i r ɒ m i k
^rohan$	r o h ɒ n
^száguld$	s aː ɡ u l d
^szomorú$	s o m o r uː
^szilimány$	s i l i m aː ɲ
^só$	ʃ oː
^föveny$	f ø v ɛ ɲ
^homok$	h o m o k
^porond$	p o r o n d
^kérődzik$	k eː r øː d͡z i k
^pendít$	p ɛ n d iː t
^szavaz$	s ɒ v ɒ z
^csikar$	t͡ʃ i k ɒ r
^kapar$	k ɒ p ɒ r
^karistol$	k ɒ r i ʃ t o l
^körömzsél$	k ø r ø m ʒ eː l
^szemügy$	s ɛ m y ɟ
^tarló$	t ɒ r l oː
^mag$	m ɒ ɡ
^foglal$	f o ɡ l ɒ l
^áru$	aː r u
^elpasszol$	ɛ l p ɒ sː o l
^ereszt$	ɛ r ɛ s t
^küld$	k y l d
^oszt$	o s t
^szeparál$	s ɛ p ɒ r aː l
^válik$	v aː l i k
^szeptember$	s ɛ p t ɛ m b ɛ r
^gyakorol$	ɟ ɒ k o r o l
^hét$	h eː t
^rosta$	r o ʃ t ɒ
^szita$	s i t ɒ
^hetven$	h ɛ t v ɛ n
^betyár$	b ɛ c aː r
^kaján$	k ɒ j aː n
^maliciózus$	m ɒ l i t͡s i oː z u ʃ
^rosszmájú$	r o sː m aː j uː
^varr$	v ɒ rː
^árnyék$	aː r ɲ eː k
^hiedelem$	h i ɛ d ɛ l ɛ m
^ráz$	r aː z
^pikáns$	p i k aː n ʃ
^savanyú$	ʃ ɒ v ɒ ɲ uː
^juh$	j u h
^polc$	p o l t͡s
^stelázsi$	ʃ t ɛ l aː ʒ i
^ing$	i n ɡ
^pozdorja$	p o z d o r j ɒ
^receg$	r ɛ t͡s ɛ ɡ
^remeg$	r ɛ m ɛ ɡ
^rémül$	r eː m y l
^szepeg$	s ɛ p ɛ ɡ
^vibrál$	v i b r aː l
^cipellős$	t͡s i p ɛ lː øː ʃ
^cipő$	t͡s i p øː
^topán$	t o p aː n
^lő$	l øː
^patika$	p ɒ t i k ɒ
^mál$	m aː l
^rév$	r eː v
^által$	aː l t ɒ l
^csuta$	t͡ʃ u t ɒ
^suta$	ʃ u t ɒ
^sódar$	ʃ oː d ɒ r
^váll$	v aː lː
^csikorog$	t͡ʃ i k o r o ɡ
^hurrog$	h u rː o ɡ
^kajdácsol$	k ɒ j d aː t͡ʃ o l
^kajdász$	k ɒ j d aː s
^kurjongat$	k u r j o n ɡ ɒ t
^rikít$	r i k iː t
^rivall$	r i v ɒ lː
^vijjog$	v i jː o ɡ
^dördít$	d ø r d iː t
^durrog$	d u rː o ɡ
^riaszt$	r i ɒ s t
^rivakodik$	r i v ɒ k o d i k
^lapát$	l ɒ p aː t
^lapocka$	l ɒ p o t͡s k ɒ
^csuk$	t͡ʃ u k
^rozzant$	r o zː ɒ n t
^szakaszkodik$	s ɒ k ɒ s k o d i k
^bárca$	b aː r t͡s ɒ
^csóva$	t͡ʃ oː v ɒ
^jel$	j ɛ l
^stempely$	ʃ t ɛ m p ɛ j
^stempli$	ʃ t ɛ m p l i
^cégér$	t͡s eː ɡ eː r
^béke$	b eː k ɛ
^nyugalom$	ɲ u ɡ ɒ l o m
^nyugodalom$	ɲ u ɡ o d ɒ l o m
^veszteg$	v ɛ s t ɛ ɡ
^kényelem$	k eː ɲ ɛ l ɛ m
^ezüst$	ɛ z y ʃ t
^lak$	l ɒ k
^szeplő$	s ɛ p l øː
^ária$	aː r i ɒ
^döng$	d ø n ɡ
^fütyül$	f y c y l
^kántál$	k aː n t aː l
^zeng$	z ɛ n ɡ
^ének$	eː n ɛ k
^bicsaklik$	b i t͡ʃ ɒ k l i k
^roskad$	r o ʃ k ɒ d
^húg$	h uː ɡ
^nővér$	n øː v eː r
^hatvan$	h ɒ t v ɒ n
^terebély$	t ɛ r ɛ b eː j
^máz$	m aː z
^menny$	m ɛ ɲː
^lánna$	l aː nː ɒ
^lemez$	l ɛ m ɛ z
^platni$	p l ɒ t n i
^tányér$	t aː ɲ eː r
^kocsi$	k o t͡ʃ i
^szán$	s aː n
^alszik$	ɒ l s i k
^durmol$	d u r m o l
^hál$	h aː l
^szunyik$	s u ɲ i k
^tente$	t ɛ n t ɛ
^korong$	k o r o n ɡ
^tárcsa$	t aː r t͡ʃ ɒ
^meredek$	m ɛ r ɛ d ɛ k
^alacsony$	ɒ l ɒ t͡ʃ o ɲ
^csira$	t͡ʃ i r ɒ
^finom$	f i n o m
^gernye$	ɡ ɛ r ɲ ɛ
^kutak$	k u t ɒ k
^miniatur$	m i n i ɒ t u r
^pikoló$	p i k o l oː
^pulya$	p u j ɒ
^szupojkó$	s u p o j k oː
^töpörtyű$	t ø p ø r c yː
^törzsök$	t ø r ʒ ø k
^sikár$	ʃ i k aː r
^sima$	ʃ i m ɒ
^kígyó$	k iː ɟ oː
^zomak$	z o m ɒ k
^harmat$	h ɒ r m ɒ t
^puha$	p u h ɒ
^torha$	t o r h ɒ
^biztos$	b i z t o ʃ
^fix$	f i k s
^merő$	m ɛ r øː
^szolid$	s o l i d
^elvélve$	ɛ l v eː l v ɛ
^elvélte$	ɛ l v eː l t ɛ
^szegrőlvégről$	s ɛ ɡ r øː l v eː ɡ r øː l
^dal$	d ɒ l
^lant$	l ɒ n t
^múzsa$	m uː ʒ ɒ
^nóta$	n oː t ɒ
^réja$	r eː j ɒ
^sanzon$	ʃ ɒ n z o n
^hamar$	h ɒ m ɒ r
^cseng$	t͡ʃ ɛ n ɡ
^csengbong$	t͡ʃ ɛ n ɡ b o n ɡ
^hang$	h ɒ n ɡ
^lé$	l eː
^leves$	l ɛ v ɛ ʃ
^rima$	r i m ɒ
^placc$	p l ɒ t͡sː
^piac$	p i ɒ t͡s
^perc$	p ɛ r t͡s
^szikra$	s i k r ɒ
^szaval$	s ɒ v ɒ l
^tanács$	t ɒ n aː t͡ʃ
^referál$	r ɛ f ɛ r aː l
^pók$	p oː k
^géniusz$	ɡ eː n i u s
^nemtő$	n ɛ m t øː
^spiritusz$	ʃ p i r i t u s
^szellem$	s ɛ lː ɛ m
^rohad$	r o h ɒ d
^roshad$	r o ʃ h ɒ d
^senyved$	ʃ ɛ ɲ v ɛ d
^destruál$	d ɛ ʃ t r u aː l
^sinkófál$	ʃ i n k oː f aː l
^vásik$	v aː ʃ i k
^veszteget$	v ɛ s t ɛ ɡ ɛ t
^vetemedik$	v ɛ t ɛ m ɛ d i k
^kanál$	k ɒ n aː l
^fejezet$	f ɛ j ɛ z ɛ t
^kút$	k uː t
^séd$	ʃ eː d
^forrás$	f o rː aː ʃ
^kútfő$	k uː t f øː
^kikelet$	k i k ɛ l ɛ t
^tavasz$	t ɒ v ɒ s
^cibóka$	t͡s i b oː k ɒ
^evet$	ɛ v ɛ t
^makog$	m ɒ k o ɡ
^mókus$	m oː k u ʃ
^pele$	p ɛ l ɛ
^kerekedik$	k ɛ r ɛ k ɛ d i k
^csillag$	t͡ʃ i lː ɒ ɡ
^húgy$	h uː ɟ
^planéta$	p l ɒ n eː t ɒ
^állam$	aː lː ɒ m
^respublika$	r ɛ ʃ p u b l i k ɒ
^státus$	ʃ t aː t u ʃ
^csakliz$	t͡ʃ ɒ k l i z
^csavar$	t͡ʃ ɒ v ɒ r
^csen$	t͡ʃ ɛ n
^happol$	h ɒ pː o l
^lop$	l o p
^mismás$	m i ʃ m aː ʃ
^oroz$	o r o z
^talp$	t ɒ l p
^istáp$	i ʃ t aː p
^kaloda$	k ɒ l o d ɒ
^packa$	p ɒ t͡s k ɒ
^tőke$	t øː k ɛ
^még$	m eː ɡ
^dufál$	d u f aː l
^faggat$	f ɒ ɡː ɒ t
^gyak$	ɟ ɒ k
^tövik$	t ø v i k
^facsar$	f ɒ t͡ʃ ɒ r
^faszari$	f ɒ s ɒ r i
^fösvény$	f ø ʃ v eː ɲ
^fukar$	f u k ɒ r
^galád$	ɡ ɒ l aː d
^piszlicsár$	p i s l i t͡ʃ aː r
^skót$	ʃ k oː t
^sopár$	ʃ o p aː r
^szűkmarkú$	s yː k m ɒ r k uː
^zsinár$	ʒ i n aː r
^agitál$	ɒ ɡ i t aː l
^kavar$	k ɒ v ɒ r
^kever$	k ɛ v ɛ r
^sodor$	ʃ o d o r
^sorol$	ʃ o r o l
^bél$	b eː l
^gyomor$	ɟ o m o r
^asztag$	ɒ s t ɒ ɡ
^kő$	k øː
^rege$	r ɛ ɡ ɛ
^csempe$	t͡ʃ ɛ m p ɛ
^góc$	ɡ oː t͡s
^kaholy$	k ɒ h o j
^kályha$	k aː j h ɒ
^pest$	p ɛ ʃ t
^szoba$	s o b ɒ
^tat$	t ɒ t
^ideg$	i d ɛ ɡ
^pating$	p ɒ t i n ɡ
^ár$	aː r
^áramlik$	aː r ɒ m l i k
^bugyog$	b u ɟ o ɡ
^hömpölyödik$	h ø m p ø j ø d i k
^öklik$	ø k l i k
^ötlik$	ø t l i k
^omlik$	o m l i k
^zubog$	z u b o ɡ
^zuhan$	z u h ɒ n
^erő$	ɛ r øː
^forsz$	f o r s
^csápol$	t͡ʃ aː p o l
^csapong$	t͡ʃ ɒ p o n ɡ
^egyez$	ɛ ɟ ɛ z
^kefe$	k ɛ f ɛ
^kongat$	k o n ɡ ɒ t
^páhog$	p aː h o ɡ
^patél$	p ɒ t eː l
^plágál$	p l aː ɡ aː l
^salapál$	ʃ ɒ l ɒ p aː l
^som$	ʃ o m
^korda$	k o r d ɒ
^kordon$	k o r d o n
^nyüst$	ɲ y ʃ t
^zsineg$	ʒ i n ɛ ɡ
^vessző$	v ɛ sː øː
^delta$	d ɛ l t ɒ
^marha$	m ɒ r h ɒ
^nyakas$	ɲ ɒ k ɒ ʃ
^antal$	ɒ n t ɒ l
^barkó$	b ɒ r k oː
^bibasz$	b i b ɒ s
^bikfic$	b i k f i t͡s
^botor$	b o t o r
^buger$	b u ɡ ɛ r
^bugris$	b u ɡ r i ʃ
^bumfordi$	b u m f o r d i
^gyáva$	ɟ aː v ɒ
^hülye$	h y j ɛ
^kába$	k aː b ɒ
^sumák$	ʃ u m aː k
^szamár$	s ɒ m aː r
^tökkelütött$	t ø kː ɛ l y t ø tː
^szuperál$	s u p ɛ r aː l
^egyszersmind$	ɛ ɟ s ɛ r ʃ m i n d
^hevenyében$	h ɛ v ɛ ɲ eː b ɛ n
^hirtelen$	h i r t ɛ l ɛ n
^nyár$	ɲ aː r
^csúcs$	t͡ʃ uː t͡ʃ
^csűcs$	t͡ʃ yː t͡ʃ
^vasárnap$	v ɒ ʃ aː r n ɒ p
^mankó$	m ɒ n k oː
^oszlop$	o s l o p
^pillér$	p i lː eː r
^rakonca$	r ɒ k o n t͡s ɒ
^tomb$	t o m b
^zsámoly$	ʒ aː m o j
^fecske$	f ɛ t͡ʃ k ɛ
^nyel$	ɲ ɛ l
^fertő$	f ɛ r t øː
^hany$	h ɒ ɲ
^lák$	l aː k
^limbus$	l i m b u ʃ
^mocsár$	m o t͡ʃ aː r
^molva$	m o l v ɒ
^pocséta$	p o t͡ʃ eː t ɒ
^pocsolya$	p o t͡ʃ o j ɒ
^posvány$	p o ʃ v aː ɲ
^szik$	s i k
^hattyú$	h ɒ cː uː
^billeg$	b i lː ɛ ɡ
^hajbókol$	h ɒ j b oː k o l
^imbolyog$	i m b o j o ɡ
^kétkedik$	k eː t k ɛ d i k
^ődöng$	øː d ø n ɡ
^kétség$	k eː t ʃ eː ɡ
^úszik$	uː s i k
^csal$	t͡ʃ ɒ l
^fírol$	f iː r o l
^csappant$	t͡ʃ ɒ pː ɒ n t
^csóvál$	t͡ʃ oː v aː l
^kelekólál$	k ɛ l ɛ k oː l aː l
^reszket$	r ɛ s k ɛ t
^asztal$	ɒ s t ɒ l
^dumál$	d u m aː l
^hantíroz$	h ɒ n t iː r o z
^rajong$	r ɒ j o n ɡ
^hanta$	h ɒ n t ɒ
^íny$	iː ɲ
^kóstál$	k oː ʃ t aː l
^kóstol$	k oː ʃ t o l
^költ$	k ø l t
^csája$	t͡ʃ aː j ɒ
^herbatea$	h ɛ r b ɒ t ɛ ɒ
^abriktol$	ɒ b r i k t o l
^tanít$	t ɒ n iː t
^lektor$	l ɛ k t o r
^mester$	m ɛ ʃ t ɛ r
^pedagógus$	p ɛ d ɒ ɡ oː ɡ u ʃ
^könny$	k ø ɲː
^tíz$	t iː z
^porcog$	p o r t͡s o ɡ
^porcan$	p o r t͡s ɒ n
^az$	ɒ z
^azután$	ɒ z u t aː n
^hát$	h aː t
^elvégre$	ɛ l v eː ɡ r ɛ
^holott$	h o l o tː
^honn$	h o nː
^oda$	o d ɒ
^onnét$	o nː eː t
^ott$	o tː
^túl$	t uː l
^ritka$	r i t k ɒ
^gyenge$	ɟ ɛ n ɡ ɛ
^karcsú$	k ɒ r t͡ʃ uː
^sugár$	ʃ u ɡ aː r
^suhancár$	ʃ u h ɒ n t͡s aː r
^surján$	ʃ u r j aː n
^mű$	m yː
^szerzet$	s ɛ r z ɛ t
^portéka$	p o r t eː k ɒ
^alít$	ɒ l iː t
^gondol$	ɡ o n d o l
^három$	h aː r o m
^harminc$	h ɒ r m i n t͡s
^ez$	ɛ z
^te$	t ɛ
^fogamzik$	f o ɡ ɒ m z i k
^tipp$	t i pː
^ezer$	ɛ z ɛ r
^fikarc$	f i k ɒ r t͡s
^fon$	f o n
^haj$	h ɒ j
^rost$	r o ʃ t
^szál$	s aː l
^keresztül$	k ɛ r ɛ s t y l
^keresztülkasul$	k ɛ r ɛ s t y l k ɒ ʃ u l
^révén$	r eː v eː n
^gór$	ɡ oː r
^sújt$	ʃ uː j t
^dohog$	d o h o ɡ
^robog$	r o b o ɡ
^csütörtök$	t͡ʃ y t ø r t ø k
^kezd$	k ɛ z d
^esztendő$	ɛ s t ɛ n d øː
^évad$	eː v ɒ d
^idő$	i d øː
^kor$	k o r
^cúca$	t͡s uː t͡s ɒ
^máma$	m aː m ɒ
^egyembelű$	ɛ ɟ ɛ m b ɛ l yː
^egyetemben$	ɛ ɟ ɛ t ɛ m b ɛ n
^össze$	ø sː ɛ
^holdá$	h o l d aː
^holnap$	h o l n ɒ p
^érint$	eː r i n t
^illet$	i lː ɛ t
^tángál$	t aː n ɡ aː l
^város$	v aː r o ʃ
^magyaráz$	m ɒ ɟ ɒ r aː z
^árkány$	aː r k aː ɲ
^csekle$	t͡ʃ ɛ k l ɛ
^kaptány$	k ɒ p t aː ɲ
^kelepce$	k ɛ l ɛ p t͡s ɛ
^szoppan$	s o pː ɒ n
^nadrág$	n ɒ d r aː ɡ
^salavári$	ʃ ɒ l ɒ v aː r i
^bizony$	b i z o ɲ
^formális$	f o r m aː l i ʃ
^klasszikus$	k l ɒ sː i k u ʃ
^való$	v ɒ l oː
^kísérel$	k iː ʃ eː r ɛ l
^kísért$	k iː ʃ eː r t
^próbál$	p r oː b aː l
^cséve$	t͡ʃ eː v ɛ
^cső$	t͡ʃ øː
^síp$	ʃ iː p
^tubus$	t u b u ʃ
^kedd$	k ɛ dː
^esztergár$	ɛ s t ɛ r ɡ aː r
^pödör$	p ø d ø r
^teker$	t ɛ k ɛ r
^teper$	t ɛ p ɛ r
^homlít$	h o m l iː t
^húsz$	h uː s
^gally$	ɡ ɒ jː
^sziporkázik$	s i p o r k aː z i k
^kolesza$	k o l ɛ s ɒ
^taliga$	t ɒ l i ɡ ɒ
^bácsi$	b aː t͡ʃ i
^bátya$	b aː c ɒ
^süv$	ʃ y v
^uj$	u j
^izgat$	i z ɡ ɒ t
^készlel$	k eː s l ɛ l
^kényszerít$	k eː ɲ s ɛ r iː t
^nógat$	n oː ɡ ɒ t
^piszkál$	p i s k aː l
^rezzeszt$	r ɛ zː ɛ s t
^tukmál$	t u k m aː l
^felette$	f ɛ l ɛ tː ɛ
^fene$	f ɛ n ɛ
^n$	n
^irdatlan$	i r d ɒ t l ɒ n
^jeles$	j ɛ l ɛ ʃ
^kurva$	k u r v ɒ
^retten$	r ɛ tː ɛ n
^roppant$	r o pː ɒ n t
^töméntelen$	t ø m eː n t ɛ l ɛ n
^váltn$	v aː l t n
^falu$	f ɒ l u
^erőszak$	ɛ r øː s ɒ k
^látogat$	l aː t o ɡ ɒ t
^vár$	v aː r
^virrad$	v i rː ɒ d
^vekni$	v ɛ k n i
^baktat$	b ɒ k t ɒ t
^keletkezik$	k ɛ l ɛ t k ɛ z i k
^allűr$	ɒ lː yː r
^folyosó$	f o j o ʃ oː
^tál$	t aː l
^akar$	ɒ k ɒ r
^háború$	h aː b o r uː
^mos$	m o ʃ
^víz$	v iː z
^hullám$	h u lː aː m
^mi$	m i
^csámpás$	t͡ʃ aː m p aː ʃ
^gányol$	ɡ aː ɲ o l
^gyarló$	ɟ ɒ r l oː
^halánk$	h ɒ l aː n k
^incifinci$	i n t͡s i f i n t͡s i
^időjárás$	i d øː j aː r aː ʃ
^szerda$	s ɛ r d ɒ
^ort$	o r t
^nyugat$	ɲ u ɡ ɒ t
^kastos$	k ɒ ʃ t o ʃ
^kicsoda$	k i t͡ʃ o d ɒ
^hol$	h o l
^merre$	m ɛ rː ɛ
^fütty$	f y cː
^fehér$	f ɛ h eː r
^patyolat$	p ɒ c o l ɒ t
^hova$	h o v ɒ
^honnét$	h o nː eː t
^fölösleg$	f ø l ø ʃ l ɛ ɡ
^széles$	s eː l ɛ ʃ
^tág$	t aː ɡ
^hitves$	h i t v ɛ ʃ
^feleség$	f ɛ l ɛ ʃ eː ɡ
^jérce$	j eː r t͡s ɛ
^győz$	ɟ øː z
^ablak$	ɒ b l ɒ k
^akna$	ɒ k n ɒ
^tok$	t o k
^szárnyék$	s aː r ɲ eː k
^tél$	t eː l
^csikasz$	t͡ʃ i k ɒ s
^farkas$	f ɒ r k ɒ ʃ
^ordas$	o r d ɒ ʃ
^asszony$	ɒ sː o ɲ
^baba$	b ɒ b ɒ
^madonna$	m ɒ d o nː ɒ
^némber$	n eː m b ɛ r
^vászoncseléd$	v aː s o n t͡ʃ ɛ l eː d
^spiné$	ʃ p i n eː
^ében$	eː b ɛ n
^gyapjú$	ɟ ɒ p j uː
^gyapot$	ɟ ɒ p o t
^rokka$	r o kː ɒ
^meló$	m ɛ l oː
^munka$	m u n k ɒ
^rabota$	r ɒ b o t ɒ
^blúz$	b l uː z
^alkörmös$	ɒ l k ø r m ø ʃ
^féreg$	f eː r ɛ ɡ
^kérész$	k eː r eː s
^métely$	m eː t ɛ j
^bugyolál$	b u ɟ o l aː l
^gomolyít$	ɡ o m o j iː t
^patyókál$	p ɒ c oː k aː l
^sárga$	ʃ aː r ɡ ɒ
^tege$	t ɛ ɡ ɛ
^teget$	t ɛ ɡ ɛ t
^tegnap$	t ɛ ɡ n ɒ p
^ti$	t i
^remonda$	r ɛ m o n d ɒ